- - - - - -
5 - - - - -
4 - - - - -
- - - 5 - 9
- - - 4 - 1
- - 9 - - 1

- - - - - 8
- - - 10 - 8
- - - - - 10
3 9 2 2 11 -
- - - 9 3 -
- - - - - 11

- - 5 2 - -
- - 10 2 6 6
- - - - 9 -
5 - - - - -
- - - 9 11 -
- - 10 11 - -

6 6 - - 3 -
3 - - - - -
7 - - 7 - -
- - - - - 2
- - - 1 5 5
- - 2 - - 1

- - - - 5 2
- - - - - -
5 - - - - 2
6 7 - - 4 4
- - 7 6 1 1
- - - - - -

- - - - - 6
- 3 - - 2 -
3 5 6 - 4 2
1 - - - - -
- - 5 4 - -
- - - 1 - -

- - - 7 - -
7 - - - - -
4 2 - - 1 -
- - - - - -
5 6 6 - 1 2
- - 5 - - 4

- - - 4 - -
- - - 7 5 -
- 7 6 - 6 -
- - - 3 - -
- 1 1 3 - -
- - - - 4 5

- 1 - - - -
- 5 - - 7 -
- - - - 4 -
- 3 5 - - 7
- - 3 4 - -
1 6 6 - - -

- - - 4 - 7
- 3 - - - 7
- - 3 - - -
- 1 1 - 6 5
- - - 5 - -
4 - - 6 - -

- 7 - - - 5
- 7 - 5 - -
- - - - - -
3 3 - - 1 4
- - - 1 - -
- - - 6 6 4

6 - - - 5 -
- 2 2 - 5 -
6 - - - 3 -
- - 7 - - -
- - 7 4 - -
- - 4 - 3 -

- - - - - -
5 1 - - 4 5
- 3 - - - 4
- 3 - - - -
- - 7 1 6 -
7 - - 6 - -

6 7 - - - 5
- - 5 4 - 4
6 - - 3 - 3
7 - - 1 - -
- - - - - -
- 1 - - - -

- - - - - 7
- 6 1 - - -
- - - 2 - -
- - - 5 2 1
- - 6 5 - -
- - - 7 3 3

4 - - - 5 5
7 7 - - - -
- - - - - 1
- - - - 6 2
- 4 - - 6 2
- - - - - 1

- 5 - - - -
- - 7 2 2 -
3 5 - - 7 -
- 4 - 1 - -
- 4 - - - -
- - - - 3 1

- 3 - - 3 -
- - - - - -
- - 5 5 2 4
- - 6 - - -
- - 7 6 - -
7 2 - - - 4

- - - - - -
- - 7 7 9 -
2 - 8 - 5 5
- - 8 - - -
- 9 4 - - -
- - 2 4 - -

10 6 6 - - 2
10 - - - - 4
11 - - 1 - -
11 - 4 2 - -
1 - - - - -
- - - - - -

- - 1 - - -
- 6 6 - 11 11
- - 8 - - 8
- - - - - 4
- 10 - - - 4
1 10 - - - -

5 - - - - -
- - 6 - - -
4 - 6 - 2 2
3 - 10 - - -
3 - - 5 - -
4 - - - - 10

5 5 - - 6 8
- - 6 2 - -
- - - - - 8
- - 11 3 - -
- - - - 11 -
2 - - - - 3

- - - - - 8
- - - 8 11 -
- - - - - -
2 - 9 2 - -
4 - 11 - - -
4 - 9 6 - 6

3 - - 1 - -
- - - - - 1
7 - 3 - - 5
- - 4 - - 5
- - - 4 - 11
7 11 - - - -

1 - - - - -
- - - - 7 7
6 1 - - - -
- - 8 - 4 -
- - - - 4 11
- 6 - 8 11 -

4 - - - - -
- 3 7 2 2 -
- 10 7 - - 3
- - - - - 5
- - - 5 - -
4 10 - - - -

- - - 4 - -
- - - 7 9 9
- 2 - - 11 5
- 2 - 7 - -
- 4 11 - - -
5 - - - - -

- 5 - - - -
- - - 9 - -
- - - - - -
5 8 7 - 9 -
- - 2 - 7 -
1 1 2 - - 8

- - - - - -
- - - 3 11 -
11 - 3 1 - -
- - 9 - - -
- 6 - - - 1
- 6 9 8 - 8

- - 7 9 9 3
- - - - - 3
- - 10 1 - -
- - 7 1 - -
- - - - - -
- - 5 - 5 10

9 - - - - -
9 6 - 1 - -
11 2 - - - 6
11 2 - - - -
- 1 - - 10 -
- - - - 10 -

- 6 - 9 - 8
- 4 - - - -
- 4 11 - 9 -
- - - 11 2 -
6 - - - - -
- - 2 8 - -