3 - 3 - - - 10
7 - 10 - - 4 -
5 - - - - 7 -
- - - - - - -
- - 8 - 9 - -
- - 8 - - - 4
- - - 5 - - 9

7 - - - - 8 10
- - 1 7 - - 10
- - - - - - 6
3 - - - 2 - -
3 - 2 1 - - 6
- - - - - - -
- - 8 - - - -

2 - 8 - 3 - -
2 - 8 - - 7 -
- - - - - - -
- - 5 4 6 - -
- 5 6 - - 3 -
- - - - - 7 -
4 - - - - - -

- 8 2 7 - - -
- 8 - - - - -
5 10 10 - - - 4
- 5 - - - - -
- - - - - 7 -
- - - - 9 - -
- - 2 9 - - 4

