- - 5 1 2
- 7 - - -
- 5 - - 2
7 - - 1 4
4 - - - -

